1,155,154,1,1,4,4
2,161,160,2,2,6,10
3,162,161,3,3,1,11
4,163,162,4,4,1,12
5,166,165,5,5,3,15
6,177,176,6,6,11,26
7,181,180,7,7,4,30
8,189,188,8,8,8,38
9,200,199,9,9,11,49
10,205,204,10,10,5,54
11,212,211,11,11,7,61
12,219,218,12,12,7,68
13,224,223,13,13,5,73
14,231,230,14,14,7,80
15,236,235,15,15,5,85
16,240,239,16,16,4,89
17,245,244,17,17,5,94
18,251,250,18,18,6,100
19,255,254,19,19,4,104
20,263,262,20,20,8,112
21,275,274,21,21,12,124
22,283,282,22,22,8,132
23,289,288,23,23,6,138
24,294,292,24,24,5,143
25,297,294,25,25,3,146
26,305,296,26,26,8,154
27,311,301,27,27,6,160
28,317,304,28,28,6,166
29,322,306,29,29,5,171
30,331,315,30,30,9,180
31,340,322,31,31,9,189
32,353,334,32,32,13,202
33,360,338,33,33,7,209
34,367,342,34,34,7,216
35,371,346,35,35,4,220
36,381,354,36,36,10,230
37,392,364,37,37,11,241
38,397,367,38,38,5,246
39,411,381,39,39,14,260
40,419,388,40,40,8,268
41,429,394,41,41,10,278
42,436,399,42,42,7,285
43,442,402,43,43,6,291
44,447,406,44,44,5,296
45,458,413,45,45,11,307
46,469,421,46,46,11,318
47,475,424,47,47,6,324
48,485,430,48,48,10,334
49,494,436,49,49,9,343
50,507,443,50,50,13,356
51,516,407,51,51,9,365
52,530,392,52,52,14,379
53,535,380,53,53,5,384
54,546,379,54,54,11,395
55,557,383,55,55,11,406
56,564,383,56,56,7,413
57,576,388,57,57,12,425
58,585,393,58,58,9,434
59,596,401,59,59,11,445
60,604,405,60,60,8,453
61,612,408,61,61,8,461
62,627,412,62,62,15,476
63,635,416,63,63,8,484
64,647,421,64,64,12,496
65,660,429,65,65,13,509
66,670,434,66,66,10,519
67,680,438,67,67,10,529
68,693,443,68,68,13,542
69,701,446,69,69,8,550
70,715,455,70,70,14,564
71,725,452,71,71,10,574
72,735,454,72,72,10,584
73,750,463,73,73,15,599
74,763,467,74,74,13,612
75,774,475,75,75,11,623
76,787,480,76,76,13,636
77,801,488,77,77,14,650
78,812,491,78,78,11,661
79,827,497,79,79,15,676
80,836,496,80,80,9,685
81,851,502,81,81,15,700
82,862,503,82,82,11,711
83,877,506,83,83,15,726
84,890,508,84,84,13,739
85,905,514,85,85,15,754
86,924,521,86,86,19,773
87,932,517,87,87,8,781
88,947,524,88,88,15,796
89,964,532,89,89,17,813
90,974,532,90,90,10,823
91,989,540,91,91,15,838
92,1000,539,92,92,11,849
93,1016,550,93,93,16,865
94,1028,551,94,94,12,877
95,1041,556,95,95,13,890
96,1058,560,96,96,17,907
97,1078,570,91,96,20,927
98,1092,574,89,96,14,941
99,1109,584,87,96,17,958
100,1124,586,88,96,15,973
101,1136,585,89,96,12,985
102,1146,583,90,96,10,995
103,1160,586,91,96,14,1009
104,1170,584,92,96,10,1019
105,1187,594,66,96,17,1036
106,1199,598,67,96,12,1048
107,1215,598,68,96,16,1064
108,1229,607,68,96,14,1078
109,1244,612,69,96,15,1093
110,1260,619,70,96,16,1109
111,1275,626,71,96,15,1124
112,1290,634,72,96,15,1139
113,1302,636,73,96,12,1151
114,1316,637,74,96,14,1165
115,1327,639,75,96,11,1176
116,1342,640,76,96,15,1191
117,1358,648,77,96,16,1207
118,1380,660,78,96,22,1229
119,1397,665,79,96,17,1246
120,1416,670,80,96,19,1265
121,1436,679,81,96,20,1285
122,1457,691,82,96,21,1306
123,1481,706,83,96,24,1330
124,1494,705,84,96,13,1343
125,1519,718,85,96,25,1368
126,1531,723,86,96,12,1380
127,1554,736,75,96,23,1403
128,1572,736,76,96,18,1421
129,1586,738,77,96,14,1435
130,1607,747,78,96,21,1456
131,1625,748,74,96,18,1474
132,1642,752,75,96,17,1491
133,1654,747,76,96,12,1503
134,1675,753,77,96,21,1524
135,1693,761,78,96,18,1542
136,1713,769,79,96,20,1562
137,1730,775,77,96,17,1579
138,1751,788,73,96,21,1600
139,1778,800,74,96,27,1627
140,1795,807,75,96,17,1644
141,1816,818,76,96,21,1665
142,1848,839,74,96,32,1697
143,1874,853,75,96,26,1723
144,1896,863,76,96,22,1745
145,1917,874,77,96,21,1766
146,1938,885,78,96,21,1787
147,1959,890,79,96,21,1808
148,1976,889,76,96,17,1825
149,1992,891,77,96,16,1841
150,2026,913,78,96,34,1875
151,2051,921,79,96,25,1900
152,2071,932,80,96,20,1920
153,2093,941,79,96,22,1942
154,2112,948,80,96,19,1961
155,2140,958,81,96,28,1989
156,2167,976,79,96,27,2016
157,2190,986,80,96,23,2039
158,2217,1001,76,96,27,2066
159,2248,1015,77,96,31,2097
160,2276,1025,78,96,28,2125
161,2297,1029,79,96,21,2146
162,2318,1038,76,96,21,2167
163,2347,1053,77,96,29,2196
164,2374,1064,78,96,27,2223
165,2401,1073,79,96,27,2250
166,2429,1084,80,96,28,2278
167,2449,1091,81,96,20,2298
168,2483,1105,82,96,34,2332
169,2516,1126,83,96,33,2365
170,2553,1142,84,96,37,2402
171,2582,1153,85,96,29,2431
172,2609,1163,86,96,27,2458
173,2645,1176,87,96,36,2494
174,2675,1195,88,96,30,2524
175,2705,1197,89,96,30,2554
176,2729,1200,90,96,24,2578
177,2770,1210,91,96,41,2619
178,2800,1219,92,96,30,2649
179,2829,1228,93,96,29,2678
180,2861,1234,94,96,32,2710
181,2886,1239,95,96,25,2735
182,2910,1247,96,96,24,2759
183,2944,1258,97,97,34,2793
184,2980,1269,98,98,36,2829
185,3035,1304,89,98,55,2884
186,3067,1314,90,98,32,2916
187,3093,1311,91,98,26,2942
188,3135,1326,92,98,42,2984
189,3167,1335,93,98,32,3016
190,3216,1356,89,98,49,3065
191,3247,1355,85,98,31,3096
192,3280,1355,86,98,33,3129
193,3314,1362,87,98,34,3163
194,3362,1377,87,98,48,3211
195,3404,1387,88,98,42,3253
196,3444,1397,82,98,40,3293
197,3473,1395,74,98,29,3322
198,3513,1409,75,98,40,3362
199,3540,1413,76,98,27,3389
200,3573,1417,76,98,33,3422
201,3607,1427,77,98,34,3456
202,3645,1440,78,98,38,3494
203,3681,1458,79,98,36,3530
204,3715,1474,80,98,34,3564
205,3745,1478,81,98,30,3594
206,3775,1489,82,98,30,3624
207,3812,1505,83,98,37,3661
208,3859,1527,84,98,47,3708
209,3898,1552,85,98,39,3747
210,3933,1566,80,98,35,3782
211,3972,1578,81,98,39,3821
212,4006,1588,81,98,34,3855
213,4052,1601,82,98,46,3901
214,4087,1606,83,98,35,3936
215,4132,1626,84,98,45,3981
216,4177,1641,85,98,45,4026
217,4214,1659,86,98,37,4063
218,4249,1664,87,98,35,4098
219,4290,1668,88,98,41,4139
220,4334,1680,89,98,44,4183
221,4368,1688,90,98,34,4217
222,4405,1697,90,98,37,4254
223,4452,1720,91,98,47,4301
224,4490,1729,92,98,38,4339
225,4532,1749,93,98,42,4381
226,4576,1772,94,98,44,4425
227,4619,1789,95,98,43,4468
228,4656,1799,96,98,37,4505
229,4695,1813,97,98,39,4544
230,4737,1828,98,98,42,4586
231,4784,1843,99,99,47,4633
232,4827,1855,100,100,43,4676
233,4861,1856,89,100,34,4710
234,4913,1875,90,100,52,4762
235,4966,1888,91,100,53,4815
236,5019,1898,92,100,53,4868
237,5060,1905,93,100,41,4909
238,5108,1916,94,100,48,4957
239,5151,1923,95,100,43,5000
240,5189,1917,96,100,38,5038
241,5233,1924,97,100,44,5082
242,5274,1922,98,100,41,5123
243,5324,1945,99,100,50,5173
244,5370,1962,100,100,46,5219
245,5419,1965,101,101,49,5268
246,5469,1980,102,102,50,5318
247,5521,2008,102,102,52,5370
248,5565,2013,103,103,44,5414
249,5613,2036,98,103,48,5462
250,5661,2058,99,103,48,5510
251,5710,2071,100,103,49,5559
252,5767,2103,101,103,57,5616
253,5809,2110,102,103,42,5658
254,5860,2135,103,103,51,5709
255,5918,2159,78,103,58,5767
256,5980,2190,78,103,62,5829
257,6041,2224,79,103,61,5890
258,6097,2244,80,103,56,5946
259,6161,2275,81,103,64,6010
260,6217,2292,82,103,56,6066
261,6274,2316,83,103,57,6123
262,6331,2346,84,103,57,6180
263,6376,2340,85,103,45,6225
264,6436,2355,86,103,60,6285
265,6509,2377,87,103,73,6358
266,6560,2384,88,103,51,6409
267,6615,2395,89,103,55,6464
268,6670,2418,90,103,55,6519
269,6734,2429,91,103,64,6583
270,6790,2447,92,103,56,6639
271,6859,2464,93,103,69,6708
272,6920,2479,94,103,61,6769
273,6968,2477,95,103,48,6817
274,7035,2485,96,103,67,6884
275,7091,2493,97,103,56,6940
276,7156,2501,97,103,65,7005
277,7219,2514,98,103,63,7068
278,7292,2538,99,103,73,7141
279,7363,2558,100,103,71,7212
280,7430,2589,101,103,67,7279
281,7493,2603,102,103,63,7342
282,7561,2626,103,103,68,7410
283,7632,2648,104,104,71,7481
284,7689,2657,105,105,57,7538
285,7757,2684,106,106,68,7606
286,7832,2719,100,106,75,7681
287,7907,2753,98,106,75,7756
288,7974,2771,99,106,67,7823
289,8033,2785,100,106,59,7882
290,8112,2809,101,106,79,7961
291,8165,2820,99,106,53,8014
292,8233,2836,100,106,68,8082
293,8321,2877,100,106,88,8170
294,8400,2901,101,106,79,8249
295,8477,2922,102,106,77,8326
296,8559,2947,103,106,82,8408
297,8628,2972,86,106,69,8477
298,8707,3005,87,106,79,8556
299,8778,3024,88,106,71,8627
300,8853,3053,89,106,75,8702
301,8919,3074,90,106,66,8768
302,9007,3110,91,106,88,8856
303,9079,3141,92,106,72,8928
304,9163,3183,93,106,84,9012
305,9265,3232,94,106,102,9114
306,9347,3263,83,106,82,9196
307,9427,3289,84,106,80,9276
308,9512,3320,85,106,85,9361
309,9600,3357,84,106,88,9449
310,9681,3385,85,106,81,9530
311,9760,3413,86,106,79,9609
312,9836,3432,87,106,76,9685
313,9916,3447,88,106,80,9765
314,10002,3479,89,106,86,9851
315,10094,3504,90,106,92,9943
316,10187,3546,91,106,93,10036
317,10273,3586,92,106,86,10122
318,10372,3628,93,106,99,10221
319,10460,3657,94,106,88,10309
320,10550,3685,95,106,90,10399
321,10638,3712,90,106,88,10487
322,10741,3754,91,106,103,10590
323,10826,3781,92,106,85,10675
324,10907,3802,93,106,81,10756
325,11029,3869,94,106,122,10878
326,11116,3895,95,106,87,10965
327,11198,3919,96,106,82,11047
328,11312,3971,97,106,114,11161
329,11427,4028,98,106,115,11276
330,11541,4074,99,106,114,11390
331,11657,4132,100,106,116,11506
332,11755,4155,101,106,98,11604
333,11865,4191,86,106,110,11714
334,11973,4222,87,106,108,11822
335,12067,4249,88,106,94,11916
336,12201,4307,85,106,134,12050
337,12299,4327,86,106,98,12148
338,12407,4349,87,106,108,12256
339,12514,4390,88,106,107,12363
340,12632,4433,89,106,118,12481
341,12744,4470,88,106,112,12593
342,12838,4486,89,106,94,12687
343,12953,4526,86,106,115,12802
344,13069,4560,87,106,116,12918
345,13157,4565,88,106,88,13006
346,13275,4608,89,106,118,13124
347,13396,4658,90,106,121,13245
348,13521,4716,91,106,125,13370
349,13635,4762,92,106,114,13484
350,13771,4822,93,106,136,13620
351,13867,4856,85,106,96,13716
352,13981,4896,86,106,114,13830
353,14110,4944,87,106,129,13959
354,14250,4997,87,106,140,14099
355,14387,5053,88,106,137,14236
356,14529,5099,89,106,142,14378
357,14659,5136,90,106,130,14508
358,14802,5197,91,106,143,14651
359,14934,5244,92,106,132,14783
360,15069,5301,93,106,135,14918
361,15205,5340,94,106,136,15054
362,15338,5388,95,106,133,15187
363,15492,5457,92,106,154,15341
364,15635,5513,90,106,143,15484
365,15750,5530,91,106,115,15599
366,15899,5580,92,106,149,15748
367,16062,5651,93,106,163,15911
368,16211,5680,94,106,149,16060
369,16343,5710,95,106,132,16192
370,16470,5745,96,106,127,16319
371,16618,5784,95,106,148,16467
372,16770,5829,96,106,152,16619
373,16917,5889,90,106,147,16766
374,17058,5922,91,106,141,16907
375,17195,5943,92,106,137,17044
376,17339,5982,83,106,144,17188
377,17459,5992,84,106,120,17308
378,17588,6021,85,106,129,17437
379,17730,6068,77,106,142,17579
380,17871,6096,78,106,141,17720
381,18013,6113,78,106,142,17862
382,18188,6177,79,106,175,18037
383,18354,6233,80,106,166,18203
384,18487,6259,81,106,133,18336
385,18630,6306,82,106,143,18479
386,18808,6369,83,106,178,18657
387,18954,6394,84,106,146,18803
388,19134,6474,85,106,180,18983
389,19305,6526,86,106,171,19154
390,19457,6566,87,106,152,19306
391,19629,6630,88,106,172,19478
392,19815,6707,89,106,186,19664
393,19977,6778,90,106,162,19826
394,20159,6852,91,106,182,20008
395,20308,6901,92,106,149,20157
396,20483,6965,93,106,175,20332
397,20643,7013,94,106,160,20492
398,20836,7100,95,106,193,20685
399,21032,7186,96,106,196,20881
400,21260,7279,97,106,228,21109
401,21436,7352,98,106,176,21285
402,21601,7428,99,106,165,21450
403,21761,7485,100,106,160,21610
404,21943,7547,101,106,182,21792
405,22117,7608,102,106,174,21966
406,22319,7693,103,106,202,22168
407,22493,7746,104,106,174,22342
408,22658,7806,105,106,165,22507
409,22873,7883,106,106,215,22722
410,23073,7952,100,106,200,22922
411,23260,8002,95,106,187,23109
412,23468,8077,96,106,208,23317
413,23701,8163,97,106,233,23550
414,23905,8215,98,106,204,23754
415,24120,8295,99,106,215,23969
416,24338,8367,100,106,218,24187
417,24544,8408,101,106,206,24393
418,24759,8461,102,106,215,24608
419,24964,8496,91,106,205,24813
420,25151,8521,92,106,187,25000
421,25355,8558,93,106,204,25204
422,25582,8602,94,106,227,25431
423,25789,8638,95,106,207,25638
424,25987,8647,96,106,198,25836
425,26227,8680,97,106,240,26076
426,26444,8688,98,106,217,26293
427,26644,8684,99,106,200,26493
428,26860,8712,100,106,216,26709
429,27094,8737,101,106,234,26943
430,27296,8721,95,106,202,27145
431,27516,8688,96,106,220,27365
432,27743,8676,97,106,227,27592
433,27982,8670,98,106,239,27831
434,28217,8687,87,106,235,28066
435,28432,8677,88,106,215,28281
436,28640,8666,89,106,208,28489
437,28878,8686,90,106,238,28727
438,29102,8683,89,106,224,28951
439,29315,8667,90,106,213,29164
440,29515,8613,91,106,200,29364
441,29719,8597,92,106,204,29568
442,29924,8561,93,106,205,29773
443,30146,8536,94,106,222,29995
444,30375,8517,95,106,229,30224
445,30602,8538,96,106,227,30451
446,30820,8538,97,106,218,30669
447,31053,8562,98,106,233,30902
448,31249,8553,99,106,196,31098
449,31487,8601,98,106,238,31336
450,31686,8575,93,106,199,31535
451,31905,8581,94,106,219,31754
452,32106,8572,95,106,201,31955
453,32310,8582,96,106,204,32159
454,32515,8589,97,106,205,32364
455,32725,8598,98,106,210,32574
456,32941,8640,99,106,216,32790
457,33141,8662,100,106,200,32990
458,33369,8698,101,106,228,33218
459,33591,8745,102,106,222,33440
460,33828,8796,103,106,237,33677
461,34027,8807,100,106,199,33876
462,34258,8878,101,106,231,34107
463,34488,8947,102,106,230,34337
464,34721,9023,103,106,233,34570
465,34942,9070,104,106,221,34791
466,35173,9124,105,106,231,35022
467,35400,9174,106,106,227,35249
468,35643,9252,107,107,243,35492
